XXXXXXXXXXXXXXXXXXXXXX
X...X..e.............X
X.g.X................X
X...X...............X.
XXXXXXXXXXXXXXXXXXXXX.
XaX.............X....X
X.X............X..XX.X
X.XXXXXXXXXX.XXXX.XXXX
X.X.....X...XX..X....X
XbX.....X.c.....XXXX.X
X...........X.fdXXXX.X
XXXXXXXXXXXXXXX......X