XXXXXXXXXXXXXXXXXXXXXXX
X....X..e.............X
X..g.X................X
X....X...............X.
XXXXXXXXXXXXXXXXXXXXXX.
XaX..............X....X
X.X.............X..XX.X
X.XXXXXXXXXXX.XXXX.XXXX
X.X......X...XX..X....X
XbX......X.c.....XXXX.X
X............X.fdXXXX.X
XXXXXXXXXXXXXXXX......X
